18 18 18 18 18 18 18 18 18 18 18 18 18 18 18 18 18 18 18 18 18 18 18 18 18 18 18 18 18 18 18 18 18 18 18 18 18 18 18 18 18 18 18 18 18 18 18 18 18 18
18 28 26 26 26 29 18 18 18 19 18 18 18 18 18 18 18 18 18 18 18 18 18 18 18 18 18 18 18 18 18 18 18 18 18 18 18 18 18 18 18 18 18 18 18 18 18 18 18 18
18 24 2 2 1 25 29 18 18 18 18 18 18 18 18 18 18 18 18 18 18 19 18 18 18 18 18 18 18 18 18 19 18 18 18 18 18 18 18 19 18 18 18 18 18 18 18 18 18 18
18 24 1 1 2 1 23 18 18 18 18 18 18 19 18 18 19 18 18 18 18 18 18 18 18 18 18 18 18 18 18 18 18 18 19 18 18 18 18 18 18 18 18 18 18 18 18 18 18 18
18 24 2 1 1 1 23 18 18 18 18 18 18 18 18 18 18 18 18 18 18 18 18 18 19 18 18 19 18 18 18 18 18 18 18 18 18 18 18 18 18 18 18 18 18 19 18 18 18 18
18 30 22 1 1 1 23 18 18 18 18 18 18 18 18 19 18 18 18 18 18 18 18 18 18 18 18 18 18 18 18 18 18 18 18 18 18 18 18 19 18 18 18 18 18 18 18 18 18 18
18 18 24 1 1 20 31 18 18 18 18 19 18 18 18 18 18 18 18 18 19 18 18 18 18 18 18 19 18 18 18 18 18 19 18 18 18 18 18 18 18 18 18 18 18 18 18 18 18 18
18 18 30 21 21 31 18 18 18 18 18 18 28 26 26 26 26 26 26 26 29 18 18 18 28 26 26 26 26 26 26 26 26 26 26 26 26 26 26 29 18 18 18 18 18 18 18 19 18 18
18 19 18 18 18 18 18 18 18 18 18 18 24 1 1 1 1 1 2 2 25 29 18 28 27 1 1 1 1 1 2 2 2 2 2 2 2 1 1 23 18 18 18 18 19 18 18 18 18 18
18 18 18 18 18 18 18 18 18 18 28 26 27 2 2 2 2 2 2 1 1 25 26 27 2 2 2 2 2 1 1 1 1 1 1 1 2 1 20 31 18 18 18 18 18 18 18 18 18 18
18 18 18 18 18 18 18 19 18 28 27 1 1 1 1 2 2 2 2 2 2 2 2 2 2 2 2 2 2 2 2 2 2 2 2 2 2 2 25 26 29 18 18 18 18 18 18 18 18 18
18 18 18 18 18 18 18 18 18 24 1 1 1 1 2 2 2 2 1 2 2 2 2 2 2 2 2 2 2 1 1 1 1 1 1 1 2 2 2 2 25 26 29 18 18 18 18 18 18 18
18 18 18 18 18 18 18 18 18 24 1 1 1 2 2 2 2 2 2 1 1 1 1 2 2 2 1 1 2 2 2 2 1 1 1 1 1 2 2 1 2 2 23 18 18 18 18 19 18 18
18 18 18 18 18 18 18 18 18 24 1 2 2 2 2 2 2 1 1 1 1 1 1 1 1 1 2 2 2 2 2 2 2 2 2 2 2 2 2 2 1 2 23 18 18 18 18 18 18 18
18 18 18 18 18 18 18 18 18 24 2 2 2 2 2 2 2 2 2 2 2 2 2 2 2 2 2 2 2 2 2 2 1 2 2 2 2 2 20 21 21 21 31 19 18 18 18 18 18 18
18 18 18 18 19 18 18 18 18 24 2 2 2 2 2 1 1 1 1 2 2 2 2 2 2 2 2 2 2 2 2 2 20 22 2 2 2 2 23 28 26 29 19 18 18 18 18 18 18 18
18 18 18 19 18 18 18 18 18 24 1 1 1 2 1 1 1 2 2 1 1 2 2 1 2 1 2 2 2 12 10 13 23 30 21 21 22 20 31 24 2 25 29 18 18 18 18 18 18 18
18 18 18 18 18 18 18 18 18 24 1 1 1 2 2 2 1 2 2 2 2 2 2 2 1 1 1 2 12 11 3 7 23 19 18 19 30 31 28 27 1 2 23 18 18 18 18 19 18 18
18 19 18 18 18 18 18 18 18 24 1 1 1 2 2 2 2 1 2 1 1 1 2 2 2 2 1 12 11 3 3 7 23 18 19 18 28 26 27 2 1 1 23 18 18 18 18 18 18 18
18 18 18 18 18 18 18 18 18 24 1 20 21 21 22 1 1 2 2 2 2 2 2 2 2 1 2 8 3 3 4 15 25 29 28 26 27 2 12 10 13 1 23 18 18 18 18 18 18 18
18 18 18 18 18 18 18 18 18 24 1 23 18 18 24 1 2 1 2 2 2 2 2 2 1 1 1 8 3 3 7 1 1 25 27 1 2 1 8 3 7 1 23 18 18 19 18 18 18 18
18 18 18 18 18 18 18 18 18 30 21 31 18 28 27 2 2 1 1 1 2 2 2 2 1 2 1 8 3 3 7 1 1 1 1 1 2 1 8 3 7 2 23 18 18 18 18 18 18 18
18 18 18 18 18 18 18 18 18 18 18 18 18 24 1 2 1 2 1 1 1 2 2 2 2 2 12 11 3 4 15 1 1 1 1 1 1 1 8 3 7 1 23 18 18 18 18 18 18 18
18 18 18 18 18 18 19 18 18 28 29 18 18 24 2 2 1 2 2 2 2 1 1 2 1 2 8 3 3 7 2 1 2 1 1 2 2 1 8 3 7 1 23 18 18 18 19 18 18 18
18 18 18 18 18 18 18 18 18 30 31 18 18 24 10 10 10 10 10 10 10 10 10 10 10 33 11 3 3 9 10 10 10 10 10 10 10 10 11 3 7 2 23 18 18 18 18 18 18 18
19 18 18 18 18 18 18 18 18 18 18 18 28 27 3 3 3 3 3 3 3 3 3 3 3 3 3 3 3 3 3 3 3 3 3 3 3 3 3 3 7 1 23 18 18 18 18 18 18 18
18 18 18 18 18 18 18 19 18 28 26 26 27 2 5 5 5 5 5 6 3 4 5 5 5 5 5 5 5 5 5 5 5 5 6 3 4 5 5 5 15 1 23 19 18 18 18 18 18 18
18 18 18 18 18 18 18 18 18 24 1 1 1 2 1 1 1 2 2 8 3 7 1 1 2 1 2 1 2 2 2 2 2 2 8 3 7 2 1 1 1 1 23 18 18 18 18 18 18 18
18 18 18 18 18 18 18 18 18 24 1 1 1 1 2 1 2 1 1 8 3 7 1 1 1 2 1 2 2 1 2 2 1 2 8 3 7 2 2 2 1 1 23 18 18 19 18 18 18 18
18 18 19 18 18 18 18 18 18 24 2 2 2 1 2 1 1 1 1 8 3 7 1 1 2 1 2 2 1 1 1 1 1 1 8 3 7 1 2 2 1 1 23 18 18 18 18 18 18 18
18 18 18 18 18 18 18 18 18 24 1 1 1 2 1 1 1 2 1 8 3 7 2 2 2 2 1 1 1 1 1 1 1 2 8 3 7 2 2 1 1 1 23 18 18 18 18 18 18 19
18 18 18 18 18 18 18 18 18 24 2 2 1 1 1 2 1 2 2 14 5 15 1 1 2 2 2 2 1 1 1 2 2 2 14 5 15 1 2 1 1 1 23 18 18 18 18 18 18 18
18 18 18 18 18 18 18 18 18 24 2 2 2 2 2 2 2 1 1 1 1 1 1 1 1 1 2 1 2 2 2 1 2 1 1 1 2 1 2 1 1 1 23 18 19 18 18 19 18 18
18 18 18 18 18 18 18 18 18 24 2 2 2 1 1 1 1 1 1 1 1 1 1 1 1 1 1 1 1 1 1 1 2 2 1 2 2 1 1 1 1 1 23 18 18 18 18 18 18 18
18 18 18 18 18 18 18 18 18 30 21 21 21 22 2 1 1 1 1 1 1 1 1 1 1 1 1 1 1 1 2 2 1 1 1 1 1 1 1 1 1 1 23 18 18 18 18 18 18 18
18 18 18 18 18 18 18 18 18 18 18 28 26 27 1 1 2 2 2 2 2 2 2 1 1 1 1 1 1 1 1 2 2 2 1 1 1 1 1 2 1 20 31 18 18 18 18 18 18 18
18 18 18 19 18 18 18 18 18 28 26 27 1 2 2 1 1 1 1 1 1 1 1 1 1 1 1 1 1 1 2 2 1 1 1 1 1 2 1 1 1 23 18 18 18 18 18 18 18 18
18 18 18 18 18 18 18 18 18 24 1 1 1 1 2 1 20 22 1 1 1 1 1 2 1 1 1 1 2 2 1 2 2 1 1 1 1 2 20 21 21 31 18 18 18 18 18 18 18 18
18 18 18 18 18 18 18 19 18 24 1 1 1 1 1 20 31 24 1 1 1 1 1 1 1 1 2 2 2 1 1 1 1 1 1 1 2 1 23 18 18 18 18 18 18 18 18 18 18 18
18 18 18 18 18 18 18 18 18 24 1 2 1 1 1 23 18 24 1 1 1 2 2 1 1 1 1 1 1 20 22 1 1 1 1 2 2 1 23 18 18 18 18 18 18 18 18 18 18 18
18 18 19 18 18 18 18 18 18 24 1 1 1 1 20 31 18 24 1 1 1 1 2 2 2 2 1 1 1 23 24 2 1 1 1 1 1 2 23 18 18 18 18 18 18 18 18 18 18 18
18 18 18 18 18 18 18 18 18 24 1 1 1 2 25 29 28 27 2 2 1 1 1 1 1 1 1 1 1 23 30 22 1 1 1 1 1 20 31 18 18 18 18 18 18 18 18 18 18 18
18 18 18 18 18 18 18 18 18 24 1 2 2 1 1 23 24 1 1 2 2 1 1 1 1 1 1 1 1 23 18 24 1 1 1 1 20 31 18 18 18 18 18 18 18 18 18 19 18 18
18 18 18 18 18 18 18 18 19 30 21 21 21 21 21 31 30 21 21 21 21 21 21 21 21 21 21 21 21 31 18 30 21 21 21 21 31 18 18 18 18 18 18 18 18 18 18 18 18 18
18 18 18 18 18 18 18 18 18 18 18 18 18 18 18 18 18 18 18 18 18 18 18 18 18 18 18 18 18 18 18 18 18 18 18 18 18 18 18 18 18 18 18 18 18 18 18 18 18 18
18 18 18 18 18 18 18 18 18 18 18 18 18 18 18 18 18 18 18 18 18 18 18 18 18 18 18 18 18 18 18 18 18 18 18 18 18 18 18 18 18 18 18 18 18 18 18 18 18 18
18 18 18 18 18 18 18 19 18 18 18 18 18 18 18 18 18 18 18 18 18 18 18 18 18 18 18 18 18 18 18 18 18 18 18 18 18 18 18 18 18 18 18 18 18 18 18 18 18 18
18 18 18 18 18 18 18 18 18 18 18 18 18 18 19 18 18 18 18 18 18 18 18 18 18 18 18 18 18 18 18 18 18 18 18 18 18 18 18 18 18 18 18 18 18 18 18 18 18 18
18 18 18 18 18 18 18 18 18 18 18 18 18 18 18 18 18 18 18 18 18 18 18 18 18 18 18 18 18 18 18 18 18 18 18 18 18 18 18 18 18 18 18 18 18 18 18 18 18 18
18 18 18 18 18 18 18 18 18 18 18 18 18 18 18 18 18 18 18 18 18 18 18 18 18 18 18 18 18 18 18 18 18 18 18 18 18 18 18 18 18 18 18 18 18 18 18 18 18 18
