0 0 0 0 0 0 0 0 0 0 0 0 0 0 0 0 0 0 0 0 0 0 0 0 0 0 0 0 0 0 0 0 0 0 0 0 0 0 0 0 0 0 0 0 0 0 0 0 0 0
0 0 0 0 0 0 0 0 0 0 0 0 0 0 0 0 0 0 0 0 0 0 0 0 0 0 0 0 0 0 0 0 0 0 0 0 0 0 0 0 0 0 0 0 0 0 0 0 0 0
0 0 0 0 0 0 0 0 0 0 18 18 18 18 18 18 18 18 18 18 18 19 18 18 18 18 18 18 18 18 18 19 18 18 18 18 18 18 18 19 18 18 0 0 0 0 0 0 0 0
0 0 0 0 0 0 0 0 0 0 18 18 18 19 18 18 19 18 18 18 18 18 18 18 18 18 18 18 18 18 18 18 18 18 19 18 18 18 18 18 18 18 0 0 0 0 0 0 0 0
0 0 0 0 0 0 0 0 0 0 18 18 18 18 18 18 18 18 18 18 18 18 18 18 19 18 18 19 18 18 18 18 18 18 18 18 18 18 18 18 18 18 0 0 0 0 0 0 0 0
0 0 0 0 0 0 0 0 0 0 18 18 18 18 18 19 18 18 18 18 18 18 18 18 18 18 18 18 18 18 18 18 18 18 18 18 18 18 18 19 18 18 0 0 0 0 0 0 0 0
0 0 0 0 0 0 0 0 0 0 18 19 18 18 18 18 18 18 18 18 19 18 18 18 18 18 18 19 18 18 18 18 18 19 18 18 18 18 18 18 18 18 0 0 0 0 0 0 0 0
0 0 0 0 0 0 0 0 0 0 26 26 26 26 26 26 26 26 26 26 26 26 26 26 26 26 26 26 26 26 26 26 26 26 26 26 26 26 26 26 26 26 0 0 0 0 0 0 0 0
0 0 0 0 0 0 0 0 0 0 2 2 2 1 1 1 1 1 2 2 2 2 2 2 2 1 1 1 1 1 2 2 2 2 2 2 2 1 1 1 1 1 0 0 0 0 0 0 0 0
0 0 0 0 0 0 0 0 0 0 1 1 2 2 2 2 2 2 2 1 1 1 1 1 2 2 2 2 2 1 1 1 1 1 1 1 2 2 2 2 2 2 0 0 0 0 0 0 0 0
0 0 0 0 0 0 0 0 0 0 1 1 1 1 1 2 2 2 2 2 2 2 2 2 2 2 2 2 2 2 2 2 2 2 2 2 2 2 2 1 1 2 0 0 0 0 0 0 0 0
0 0 0 0 0 0 0 0 0 0 1 1 1 1 2 2 2 2 1 2 2 2 2 2 2 2 2 2 2 1 1 1 1 1 1 1 2 2 2 2 2 2 0 0 0 0 0 0 0 0
0 0 0 0 0 0 0 0 0 0 1 1 1 2 2 2 2 2 2 2 1 1 1 2 2 2 1 1 2 2 2 2 1 1 1 1 1 2 2 1 2 2 0 0 0 0 0 0 0 0
0 0 0 0 0 0 0 0 0 0 1 2 2 2 2 2 2 1 1 1 1 1 1 1 1 1 2 2 2 2 2 2 2 2 2 2 2 2 2 2 1 2 0 0 0 0 0 0 0 0
0 0 0 0 0 0 0 0 0 0 2 2 2 2 2 2 2 2 2 2 2 2 2 2 2 2 2 2 2 2 2 2 1 2 2 2 2 2 2 2 2 2 0 0 0 0 0 0 0 0
0 0 0 0 0 0 0 0 0 0 2 2 2 2 2 1 1 1 1 2 2 2 2 2 2 2 2 2 2 2 2 2 2 2 2 2 2 2 1 1 1 2 0 0 0 0 0 0 0 0
0 0 0 0 0 0 0 0 0 0 1 1 1 2 1 1 1 2 2 1 1 2 2 1 2 1 2 2 2 12 10 13 20 21 21 21 22 1 1 1 2 1 0 0 0 0 0 0 0 0
0 0 0 0 0 0 0 0 0 0 1 1 1 2 2 2 1 2 2 2 2 2 2 2 1 1 1 2 12 11 3 7 23 19 18 19 24 1 2 2 1 2 0 0 0 0 0 0 0 0
0 0 0 0 0 0 0 0 0 0 1 1 1 2 2 2 2 1 2 1 1 1 2 2 2 2 1 12 11 3 3 7 23 18 19 18 24 2 2 2 1 1 0 0 0 0 0 0 0 0
0 0 0 0 0 0 0 0 0 0 1 1 1 2 12 10 13 2 2 2 2 2 2 2 2 1 2 8 3 3 4 15 25 26 26 26 27 2 12 10 13 1 0 0 0 0 0 0 0 0
0 0 0 0 0 0 0 0 0 0 1 1 2 2 8 3 7 1 2 2 2 2 2 2 1 1 1 8 3 3 7 1 1 1 1 1 2 1 8 3 7 1 0 0 0 0 0 0 0 0
0 0 0 0 0 0 0 0 0 0 1 2 2 2 8 3 7 1 1 1 2 2 2 2 1 2 1 8 3 3 7 1 1 1 1 1 2 1 8 3 7 2 0 0 0 0 0 0 0 0
0 0 0 0 0 0 0 0 0 0 1 2 2 2 8 3 7 2 1 1 1 2 2 2 2 2 12 11 3 4 15 1 1 1 1 1 1 1 8 3 7 1 0 0 0 0 0 0 0 0
0 0 0 0 0 0 0 0 0 0 1 2 2 2 8 3 7 2 2 2 2 1 1 2 1 2 8 3 3 7 2 1 2 1 1 2 2 1 8 3 7 1 0 0 0 0 0 0 0 0
0 0 0 0 0 0 0 0 0 0 1 12 10 10 11 3 9 10 10 10 10 10 10 10 10 33 11 3 3 9 10 10 10 10 10 10 10 10 11 3 7 2 0 0 0 0 0 0 0 0
0 0 0 0 0 0 0 0 0 0 1 8 3 3 3 3 3 3 3 3 3 3 3 3 3 3 3 3 3 3 3 3 3 3 3 3 3 3 3 3 7 1 0 0 0 0 0 0 0 0
0 0 0 0 0 0 0 0 0 0 2 14 5 5 5 5 5 5 5 6 3 4 5 5 5 5 5 5 5 5 5 5 5 5 6 3 4 5 5 5 15 1 0 0 0 0 0 0 0 0
0 0 0 0 0 0 0 0 0 0 1 1 1 1 1 1 1 2 2 8 3 7 1 1 2 1 2 1 2 2 2 2 2 2 8 3 7 2 1 1 1 1 0 0 0 0 0 0 0 0
0 0 0 0 0 0 0 0 0 0 1 1 1 1 2 1 2 1 1 8 3 7 1 1 1 2 1 2 2 1 2 2 1 2 8 3 7 2 2 2 1 1 0 0 0 0 0 0 0 0
0 0 0 0 0 0 0 0 0 0 2 2 2 1 2 1 1 1 1 8 3 7 1 1 2 1 2 2 1 1 1 1 1 1 8 3 7 1 2 2 1 1 0 0 0 0 0 0 0 0
0 0 0 0 0 0 0 0 0 0 1 1 1 2 1 1 1 2 1 8 3 7 2 2 2 2 1 1 1 1 1 1 1 2 8 3 7 2 2 1 1 1 0 0 0 0 0 0 0 0
0 0 0 0 0 0 0 0 0 0 2 2 1 1 1 2 1 2 2 14 5 15 1 1 2 2 2 2 1 1 1 2 2 2 14 5 15 1 2 1 1 1 0 0 0 0 0 0 0 0
0 0 0 0 0 0 0 0 0 0 2 2 2 2 2 2 2 1 1 1 1 1 1 1 1 1 2 1 2 2 2 1 2 1 1 1 2 1 2 1 1 1 0 0 0 0 0 0 0 0
0 0 0 0 0 0 0 0 0 0 2 2 2 1 1 1 1 1 1 1 1 1 1 1 1 1 1 1 1 1 1 1 2 2 1 2 2 1 1 1 1 1 0 0 0 0 0 0 0 0
0 0 0 0 0 0 0 0 0 0 0 0 0 0 0 0 0 0 0 0 0 0 0 0 0 0 0 0 0 0 0 0 0 0 0 0 0 0 0 0 0 0 0 0 0 0 0 0 0 0
0 0 0 0 0 0 0 0 0 0 0 0 0 0 0 0 0 0 0 0 0 0 0 0 0 0 0 0 0 0 0 0 0 0 0 0 0 0 0 0 0 0 0 0 0 0 0 0 0 0
0 0 0 0 0 0 0 0 0 0 0 0 0 0 0 0 0 0 0 0 0 0 0 0 0 0 0 0 0 0 0 0 0 0 0 0 0 0 0 0 0 0 0 0 0 0 0 0 0 0
0 0 0 0 0 0 0 0 0 0 0 0 0 0 0 0 0 0 0 0 0 0 0 0 0 0 0 0 0 0 0 0 0 0 0 0 0 0 0 0 0 0 0 0 0 0 0 0 0 0
0 0 0 0 0 0 0 0 0 0 0 0 0 0 0 0 0 0 0 0 0 0 0 0 0 0 0 0 0 0 0 0 0 0 0 0 0 0 0 0 0 0 0 0 0 0 0 0 0 0
0 0 0 0 0 0 0 0 0 0 0 0 0 0 0 0 0 0 0 0 0 0 0 0 0 0 0 0 0 0 0 0 0 0 0 0 0 0 0 0 0 0 0 0 0 0 0 0 0 0
0 0 0 0 0 0 0 0 0 0 0 0 0 0 0 0 0 0 0 0 0 0 0 0 0 0 0 0 0 0 0 0 0 0 0 0 0 0 0 0 0 0 0 0 0 0 0 0 0 0
0 0 0 0 0 0 0 0 0 0 0 0 0 0 0 0 0 0 0 0 0 0 0 0 0 0 0 0 0 0 0 0 0 0 0 0 0 0 0 0 0 0 0 0 0 0 0 0 0 0
0 0 0 0 0 0 0 0 0 0 0 0 0 0 0 0 0 0 0 0 0 0 0 0 0 0 0 0 0 0 0 0 0 0 0 0 0 0 0 0 0 0 0 0 0 0 0 0 0 0
0 0 0 0 0 0 0 0 0 0 0 0 0 0 0 0 0 0 0 0 0 0 0 0 0 0 0 0 0 0 0 0 0 0 0 0 0 0 0 0 0 0 0 0 0 0 0 0 0 0
0 0 0 0 0 0 0 0 0 0 0 0 0 0 0 0 0 0 0 0 0 0 0 0 0 0 0 0 0 0 0 0 0 0 0 0 0 0 0 0 0 0 0 0 0 0 0 0 0 0
0 0 0 0 0 0 0 0 0 0 0 0 0 0 0 0 0 0 0 0 0 0 0 0 0 0 0 0 0 0 0 0 0 0 0 0 0 0 0 0 0 0 0 0 0 0 0 0 0 0
0 0 0 0 0 0 0 0 0 0 0 0 0 0 0 0 0 0 0 0 0 0 0 0 0 0 0 0 0 0 0 0 0 0 0 0 0 0 0 0 0 0 0 0 0 0 0 0 0 0
0 0 0 0 0 0 0 0 0 0 0 0 0 0 0 0 0 0 0 0 0 0 0 0 0 0 0 0 0 0 0 0 0 0 0 0 0 0 0 0 0 0 0 0 0 0 0 0 0 0
0 0 0 0 0 0 0 0 0 0 0 0 0 0 0 0 0 0 0 0 0 0 0 0 0 0 0 0 0 0 0 0 0 0 0 0 0 0 0 0 0 0 0 0 0 0 0 0 0 0
0 0 0 0 0 0 0 0 0 0 0 0 0 0 0 0 0 0 0 0 0 0 0 0 0 0 0 0 0 0 0 0 0 0 0 0 0 0 0 0 0 0 0 0 0 0 0 0 0 0